****************
*S    *     *  *
****  *  *  *  *
*  *     *     *
*  *******  ****
*           *  *
****  ****--*  *
*     *     |  *
*  *  ****  *  *
*K *  *     *E * 
****************